111111111111111111111111111
1E0000000000000000000000001
1C1001010010000010100100001
101001001010101000100100001
1P0000000000000000000000001
111111111111111111111111111
